%%%%%%%%%%%%%%%%%%%%%%%%%%%%
%........P....%............%
%.%%.%.%%%%%%.%.........%%.%
%.%............%.........%.%
%.%.%%.%%  %%.%%.........%.%
%......%....%..............%
%.%.%%.%%%%%%.%%.........%.%
%.%......................%.%
%.%%.%.%%%%%%.%.........%%.%
%....P....o....%...........%
%%%%%%%%%%%%%%%%%%%%%%%%%%%%
