%%%%%%%%%%%%%%%%%%%%%%%%%%%%%%%%%%%%%%%%
%P...%...oo...%...o......%...oo...%...o%
%.%%.%.%%%%%%.%.%%%%%%%%.%.%%%%%%.%.%%.%
%.%..............%.%%.%..............%.%
%.%.%%.%%% %%.%%.%.%%.%.%%.%% %%%.%%.%.%
%......%....%..............%....%......%
%.%.%%.%% %%%.%%.%.%%.%.%%.%%% %%.%%.%.%
%.%..............%.%%.%..............%.%
%.%%.%.%%%%%%.%.%%%%%%%%.%.%%%%%%.%.%%.%
%o...%...oo...%......o...%...oo...%...P%
%%%%%%%%%%%%%%%%%%%%%%%%%%%%%%%%%%%%%%%%