%%%%%%%%%%%%%%%%%%%%%%%%%%%%%%%%%%
%....P................o........%.%
%.%%.%.%%%%%%.%.%%.%%.%.%%%%%%.%.%
%.%...........%.%%.%...........%.%
%.%%.%%%%%%..%%....%%.%%%%%%..%%.%
%......%................%....%...%
%.%%.........%%%%%.%%.........%%%%
%........o................o...%%%%
%.%%.%%%%%%.%%..%%.%%.%%%%%%.%%..%
%....o....P...........o..........%
%%%%%%%%%%%%%%%%%%%%%%%%%%%%%%%%%%