%%%%%%%%%%%%%%%%%%%%%%%%%%%
%........................P%
%.........................%
%.........................%
%.........................%
%.........................%
%.........................%
%.........................%
%P........................%
%%%%%%%%%%%%%%%%%%%%%%%%%%%