%%%%%%%%%%%%%%%%%%%%%%%%%%%
% ......    ....  ...... P%
%o.   ...  ..... ...  ... %
%     ...    .. ...  o..  %
%  ......    ... ...  ... %
%  ... ..    ... ...  ... %
%     ...    ... ...  ... %
%..   ...    ... ...  ... %
% P......    .... .. .... %
%%%%%%%%%%%%%%%%%%%%%%%%%%%